46 47 46 48 49 50 49 51 46 47 48 49 50 49 50 49 50 49 50 49 51 52 46 46 47 52 46 47 46 52 46 52 52 52 47 52 52 47 48 49 51 47 53 54 54 54 54 54 54 54 53 54 54 54 54 54 54 54 54 54 54 54 54 54 54 54 54 54 54 54 54 54 54 54 54 54 54 54 54 54 54 55 55 55 55 55 55 55 55 55 55 55 55 55 55 55 55 55 55 56 52 52 52 52
47 52 52 57 58 59 58 60 47 52 57 58 59 58 59 58 59 58 59 58 60 46 47 52 52 46 47 46 47 52 52 47 47 52 46 47 52 52 57 58 60 46 61 61 61 61 61 61 61 61 61 61 61 61 61 61 61 61 1 1 1 1 1 61 61 61 61 61 1 1 1 1 1 1 1 1 1 61 61 1 2 54 54 54 54 54 54 54 53 54 54 54 54 54 54 54 54 54 54 54 3 4 5 6
52 7 8 9 7 9 7 7 8 8 8 9 7 8 8 9 9 9 8 8 7 8 8 9 52 47 52 52 7 8 8 8 9 52 52 52 52 7 8 8 8 8 9 10 10 10 10 10 10 10 10 10 10 10 10 10 10 10 10 61 61 61 61 61 10 10 10 10 10 1 61 61 1 1 1 1 1 61 10 10 1 61 61 1 1 1 1 1 1 1 1 1 1 1 61 61 61 61 1 1 11 12 13 14
52 10 10 10 10 10 10 10 10 10 10 10 10 10 10 10 10 10 10 10 10 10 10 10 15 16 16 17 10 10 10 10 10 15 16 16 17 10 10 10 10 10 10 10 10 32 32 32 32 32 32 32 32 32 32 32 32 32 10 10 10 10 10 10 10 32 32 32 32 61 10 10 1 61 61 1 1 10 10 32 1 10 10 61 61 61 61 1 1 1 1 1 61 61 10 10 10 10 61 1 19 20 13 14
21 18 18 18 18 10 10 10 18 18 18 18 18 10 10 18 18 18 32 32 22 22 22 32 21 21 21 21 32 32 32 32 32 21 21 21 21 32 32 32 32 32 32 32 32 32 32 22 22 32 10 10 10 10 10 10 10 32 32 32 32 32 32 32 32 32 22 32 10 10 10 32 1 10 10 61 61 32 32 22 1 32 10 10 10 10 10 1 1 61 61 1 10 10 32 22 22 22 10 61 23 24 25 26
27 28 28 28 29 18 18 18 10 18 18 10 30 18 18 31 28 29 32 32 32 32 32 31 33 21 21 27 28 28 28 28 28 33 21 21 27 28 29 32 32 32 32 32 32 32 32 32 32 30 32 32 32 32 32 32 32 32 32 32 10 10 32 10 10 32 32 32 32 32 32 32 1 32 10 10 10 32 32 32 1 32 32 32 32 32 32 61 1 10 10 1 32 32 32 32 32 32 32 10 34 35 13 14
21 21 21 21 36 37 37 37 38 39 39 40 41 37 37 42 21 36 38 39 39 40 37 42 21 21 21 21 21 21 21 21 21 21 21 21 21 21 36 37 37 37 37 38 39 39 39 40 37 41 37 37 37 38 39 43 10 10 10 10 32 32 32 32 32 32 32 32 32 32 32 32 1 10 32 32 32 32 10 32 1 32 32 32 32 10 10 10 1 32 32 1 32 32 10 10 10 10 10 10 10 44 45 14